R 600 400
NO ./path_to_the_north_texture
SO ./path_to_the_south_texture
WE ./path_to_the_west_texture
EA ./path_to_the_east_texture

S ./path_to_the_sprite_texture
F 220,100,0
C 225,30,0

1111111111111
1000000001111
1101100000001
1101100111001
1000111101001
1000100001001
1000100111001
11N1100000001
1111111111111
